Ward,Precinct,Reg_Vote_10/1/19,Tot_Early/Absentee_Vote,Winner1st_Vote,Total_Vote,Early/Abs_Vote%,LastCouncil_Vote%,Tot_Vote%,Vote_Diff%,Winner_Vote%,SchoolBoard_Vote,SchoolBoard_Vote%,Min_DFL(endorse),DFL_Vote%,Trash_Yes,Trash_No,Trash_Total,Trash_No%,NO_Cand1st_Vote ,No_Cand_Align,YES_Cand1st_Vote ,Yes_Cand_Align,Trash_Vote_Diff
1,Saint Paul W-1 P-1,1170,39,228,569,6.85,24.78%,48.63,23.85,40.07,402,70.65,242,60.20,431,151,582,25.95,33,-118,531,100,13
1,Saint Paul W-1 P-2,2185,126,389,778,16.20,13.10%,35.61,22.51,50.00,490,62.98,290,59.18,561,203,764,26.57,38,-165,737,176,-14
1,Saint Paul W-1 P-3,1914,37,178,491,7.54,9.71%,25.65,15.94,36.25,289.75,59.01,148,51.08,307,176,483,36.44,40,-136,450,143,-8
1,Saint Paul W-1 P-4,1389,39,154,359,10.86,10.57%,25.85,15.28,42.90,219,61.00,126,57.53,210,139,349,39.83,35,-104,324,114,-10
1,Saint Paul W-1 P-5,1376,34,105,357,9.52,11.29%,25.94,14.65,29.41,232.5,65.13,79,33.98,177,172,349,49.28,16,-156,341,164,-8
1,Saint Paul W-1 P-6,2810,78,309,924,8.44,12.51%,32.88,20.37,33.44,615,66.56,357,58.05,590,321,911,35.24,66,-255,854,264,-13
1,Saint Paul W-1 P-7,1495,61,274,665,9.17,18.28%,44.48,26.20,41.20,460.75,69.29,312,67.72,456,211,667,31.63,47,-164,614,158,2
1,Saint Paul W-1 P-8,2140,77,233,636,12.11,12.79%,29.72,16.93,36.64,397.75,62.54,245,61.60,427,212,639,33.18,43,-169,590,163,3
1,Saint Paul W-1 P-9,2367,53,246,460,11.52,8.18%,19.43,11.25,53.48,290.5,63.15,118,40.62,238,213,451,47.23,45,-168,411,173,-9
1,Saint Paul W-1 P-10,469,7,40,98,7.14,7.92%,20.90,12.98,40.82,57,58.16,17,29.82,38,55,93,59.14,18,-37,79,41,-5
1,Saint Paul W-1 P-11,1143,44,78,218,20.18,11.53%,19.07,7.54,35.78,138.5,63.53,51,36.82,119,86,205,41.95,26,-60,191,72,-13
1,Saint Paul W-1 P-12,335,25,69,149,16.78,20.12%,44.48,24.36,46.31,97.75,65.60,59,60.36,102,54,156,34.62,13,-41,135,33,7
1,Saint Paul W-1 P-13,1174,69,226,433,15.94,15.42%,36.88,21.46,52.19,284.75,65.76,148,51.98,276,163,439,37.13,27,-136,404,128,6
1,Saint Paul W-1 P-14,975,55,167,251,21.91,13.62%,25.74,12.12,66.53,141.5,56.37,43,30.39,160,54,214,25.23,28,-26,222,62,-37
1,Saint Paul W-1 P-15,731,27,71,155,17.42,5.29%,21.20,15.91,45.81,95.75,61.77,34,35.51,69,88,157,56.05,23,-65,128,59,2
1,Saint Paul W-1 P-16,251,16,30,71,22.54,13.19%,28.29,15.10,42.25,46.5,65.49,28,60.22,43,30,73,41.10,6,-24,65,22,2
2,Saint Paul W-2 P-1,1604,65,498,703,9.25,27.63%,43.83,16.20,70.84,477.5,67.92,293,61.36,485,237,722,32.83,170,-67,498,13,19
2,Saint Paul W-2 P-2,1691,57,537,748,7.62,27.22%,44.23,17.01,71.79,499.25,66.74,279,55.88,542,230,772,29.79,183,-47,537,-5,24
2,Saint Paul W-2 P-3,2705,105,483,836,12.56,17.35%,30.91,13.56,57.78,529.25,63.31,277,52.34,507,391,898,43.54,272,-119,483,-24,62
2,Saint Paul W-2 P-4,1545,53,340,503,10.54,19.62%,32.56,12.94,67.59,344,68.39,186,54.07,345,175,520,33.65,142,-33,340,-5,17
2,Saint Paul W-2 P-5,2398,67,444,823,8.14,22.56%,34.32,11.76,53.95,517,62.82,283,54.74,483,378,861,43.90,314,-64,444,-39,38
2,Saint Paul W-2 P-6,620,20,115,192,10.42,17.25%,30.97,13.72,59.90,107.5,55.99,44,40.93,87,98,185,52.97,55,-43,115,28,-7
2,Saint Paul W-2 P-7,2271,78,378,617,12.64,17.09%,27.17,10.08,61.26,380.5,61.67,217,57.03,392,245,637,38.46,201,-44,378,-14,20
2,Saint Paul W-2 P-8,1248,73,151,285,25.61,12.96%,22.84,9.88,52.98,180.5,63.33,99,54.85,188,102,290,35.17,106,4,151,-37,5
2,Saint Paul W-2 P-9,2064,51,387,574,8.89,18.37%,27.81,9.44,67.42,392.5,68.38,201,51.21,399,161,560,28.75,156,-5,387,-12,-14
2,Saint Paul W-2 P-11,2927,97,488,702,13.82,12.35%,23.98,11.63,69.52,471.25,67.13,279,59.20,497,197,694,28.39,179,-18,488,-9,-8
2,Saint Paul W-2 P-12,1766,52,400,665,7.82,25.79%,37.66,11.87,60.15,423.75,63.72,253,59.71,405,285,690,41.30,213,-72,400,-5,25
2,Saint Paul W-2 P-13,1546,81,282,495,16.36,23.13%,32.02,8.89,56.97,327.75,66.21,183,55.84,297,221,518,42.66,163,-58,282,-15,23
2,Saint Paul W-2 P-14,1710,43,241,487,8.83,18.21%,28.48,10.27,49.49,297,60.99,166,55.89,247,257,504,50.99,197,-60,241,-6,17
2,Saint Paul W-2 P-15,2740,57,285,491,11.61,11.27%,17.92,6.65,58.04,300.5,61.20,157,52.25,247,245,492,49.80,168,-77,285,38,1
3,Saint Paul W-3 P-1,2089,110,613,1094,10.05,20.09%,52.37,32.28,56.03,700.25,64.01,386,55.12,742,363,1105,32.85,476,113,613,-129,11
3,Saint Paul W-3 P-2,2501,127,776,1255,10.12,21.65%,50.18,28.53,61.83,811,64.62,455,56.10,839,445,1284,34.66,471,26,776,-63,29
3,Saint Paul W-3 P-3,2745,196,681,1157,16.94,15.56%,42.15,26.59,58.86,735.25,63.55,380,51.68,777,396,1173,33.76,470,74,681,-96,16
3,Saint Paul W-3 P-4,1368,181,380,619,29.24,23.11%,45.25,22.14,61.39,427,68.98,208,48.71,426,190,616,30.84,237,47,380,-46,-3
3,Saint Paul W-3 P-5,1923,96,392,668,14.37,13.73%,34.74,21.01,58.68,451.5,67.59,224,49.61,439,219,658,33.28,270,51,392,-47,-10
3,Saint Paul W-3 P-6,2146,122,523,958,12.73,16.20%,44.64,28.44,54.59,571.25,59.63,308,53.92,605,359,964,37.24,431,72,523,-82,6
3,Saint Paul W-3 P-7,1403,27,418,544,4.96,19.08%,38.77,19.69,76.84,392.75,72.20,254,64.67,454,104,558,18.64,126,22,418,-36,14
3,Saint Paul W-3 P-8,1622,130,596,877,14.82,20.63%,54.07,33.44,67.96,619,70.58,376,60.74,642,266,908,29.30,278,12,596,-46,31
3,Saint Paul W-3 P-9,2511,161,780,1234,13.05,17.93%,49.14,31.21,63.21,803.5,65.11,428,53.27,862,392,1254,31.26,452,60,780,-82,20
3,Saint Paul W-3 P-10,1523,103,415,750,13.73,17.77%,49.24,31.47,55.33,459.75,61.30,205,44.59,502,256,758,33.77,332,76,415,-87,8
3,Saint Paul W-3 P-11,1967,39,221,369,10.57,8.22%,18.76,10.54,59.89,268,72.63,113,42.16,230,144,374,38.50,146,2,221,-9,5
3,Saint Paul W-3 P-12,1807,77,624,931,8.27,18.91%,51.52,32.61,67.02,626.5,67.29,358,57.14,673,286,959,29.82,303,17,624,-49,28
3,Saint Paul W-3 P-13,1855,101,564,917,11.01,21.47%,49.43,27.96,61.50,623.75,68.02,354,56.75,627,306,933,32.80,351,45,564,-63,16
3,Saint Paul W-3 P-14,3618,213,1032,1865,11.42,18.66%,51.55,32.89,55.34,1185.75,63.58,614,51.78,1216,684,1900,36.00,825,141,1032,-184,35
4,Saint Paul W-4 P-1,1626,57,504,711,8.02,26.36%,43.73,17.37,70.89,516.75,72.68,285,55.15,557,163,720,22.64,207,44,504,-53,9
4,Saint Paul W-4 P-2,1348,72,539,694,10.37,37.82%,51.48,13.66,77.67,526,75.79,228,43.35,596,120,716,16.76,152,32,539,-57,22
4,Saint Paul W-4 P-3,2405,48,427,583,8.23,7.98%,24.24,16.26,73.24,414.5,71.10,291,70.21,470,119,589,20.20,155,36,427,-43,6
4,Saint Paul W-4 P-4,1812,92,352,759,12.12,20.66%,41.89,21.23,46.38,509.75,67.16,320,62.78,496,284,780,36.41,405,121,352,-144,21
4,Saint Paul W-4 P-5,1344,53,241,580,9.14,22.19%,43.15,20.96,41.55,369.5,63.71,217,58.73,373,210,583,36.02,335,125,241,-132,3
4,Saint Paul W-4 P-6,1538,44,209,409,10.76,13.34%,26.59,13.25,51.10,293.5,71.76,180,61.33,303,109,412,26.46,200,91,209,-94,3
4,Saint Paul W-4 P-7,1831,98,375,794,12.34,23.63%,43.36,19.73,47.23,534.75,67.35,279,52.17,562,262,824,31.80,417,155,375,-187,30
4,Saint Paul W-4 P-8,2224,75,504,808,9.28,18.84%,36.33,17.49,62.38,590.25,73.05,375,63.53,594,224,818,27.38,300,76,504,-90,10
4,Saint Paul W-4 P-9,1664,127,282,537,23.65,16.47%,32.27,15.80,52.51,372.75,69.41,233,62.51,379,164,543,30.20,251,87,282,-97,6
4,Saint Paul W-4 P-10,2030,75,536,939,7.99,22.79%,46.26,23.47,57.08,646,68.80,427,66.10,705,246,951,25.87,399,153,536,-169,12
4,Saint Paul W-4 P-11,2232,157,520,909,17.27,23.12%,40.73,17.61,57.21,608.75,66.97,343,56.34,669,262,931,28.14,383,121,520,-149,22
4,Saint Paul W-4 P-12,1727,73,316,484,15.08,11.02%,28.03,17.01,65.29,354.75,73.30,227,63.99,378,126,504,25.00,167,41,316,-62,20
4,Saint Paul W-4 P-13,1498,31,316,550,5.64,19.31%,36.72,17.41,57.45,384.5,69.91,227,59.04,370,183,553,33.09,232,49,316,-54,3
4,Saint Paul W-4 P-14,1463,26,381,570,4.56,20.86%,38.96,18.10,66.84,414,72.63,310,74.88,447,138,585,23.59,184,46,381,-66,15
4,Saint Paul W-4 P-15,1526,44,394,645,6.82,19.47%,42.27,22.80,61.09,458.25,71.05,299,65.25,498,173,671,25.78,248,75,394,-104,26
5,Saint Paul W-5 P-1,2054,149,501,858,17.37,24.38%,41.77,17.39,58.39,544.5,63.46,278,51.06,584,296,880,33.64,350,54,501,-83,22
5,Saint Paul W-5 P-2,2508,201,688,1254,16.03,37.99%,50.00,12.01,54.86,798.25,63.66,441,55.25,825,456,1281,35.60,558,102,688,-137,27
5,Saint Paul W-5 P-3,2085,205,550,959,21.38,31.30%,46.00,14.70,57.35,631.5,65.85,372,58.91,613,341,954,35.74,407,66,550,-63,-5
5,Saint Paul W-5 P-4,3594,107,396,858,12.47,13.60%,23.87,10.27,46.15,564.5,65.79,291,51.55,454,416,870,47.82,459,43,396,-58,12
5,Saint Paul W-5 P-5,1904,30,216,356,8.43,10.20%,18.70,8.50,60.67,234.75,65.94,85,36.21,149,134,283,47.35,136,2,216,67,-73
5,Saint Paul W-5 P-6,1905,55,198,472,11.65,10.94%,24.78,13.84,41.95,283,59.96,131,46.29,216,259,475,54.53,270,11,198,-18,3
5,Saint Paul W-5 P-7,1198,24,97,246,9.76,10.01%,20.53,10.52,39.43,134.25,54.57,56,41.71,100,148,248,59.68,147,-1,97,-3,2
5,Saint Paul W-5 P-8,2456,51,265,430,11.86,9.53%,17.51,7.98,61.63,275.25,64.01,116,42.14,187,245,432,56.71,163,-82,265,78,2
5,Saint Paul W-5 P-9,1783,30,159,349,8.60,8.96%,19.57,10.61,45.56,235,67.34,93,39.57,161,196,357,54.90,186,-10,159,-2,8
5,Saint Paul W-5 P-10,659,8,59,99,8.08,7.59%,15.02,7.43,59.60,68.25,68.94,39,57.14,40,56,96,58.33,38,-18,59,19,-3
6,Saint Paul W-6 P-1,1422,42,203,513,8.19,12.04%,36.08,24.04,39.57,286.5,55.85,154,53.75,308,190,498,38.15,130,-60,382,74,-15
6,Saint Paul W-6 P-2,1267,39,225,584,6.68,19.74%,46.09,26.35,38.53,364.5,62.41,201,55.14,391,197,588,33.50,131,-66,453,62,4
6,Saint Paul W-6 P-3,1604,46,241,495,9.29,13.06%,30.86,17.80,48.69,272.5,55.05,88,32.29,250,223,473,47.15,101,-122,393,143,-22
6,Saint Paul W-6 P-4,1971,57,248,513,11.11,9.05%,26.03,16.98,48.34,249.5,48.64,113,45.29,263,215,478,44.98,129,-86,383,120,-35
6,Saint Paul W-6 P-5,2258,106,284,621,17.07,9.75%,27.50,17.75,45.73,322.25,51.89,138,42.82,291,306,597,51.26,188,-118,429,138,-24
6,Saint Paul W-6 P-6,2599,117,354,674,17.36,7.78%,25.93,18.15,52.52,354,52.52,165,46.61,309,353,662,53.32,187,-166,487,178,-12
6,Saint Paul W-6 P-7,681,42,96,175,24.00,11.24%,25.70,14.46,54.86,95.5,54.57,32,33.51,93,64,157,40.76,41,-23,133,40,-18
6,Saint Paul W-6 P-8,1623,58,192,339,17.11,8.54%,20.89,12.35,56.64,150,44.25,55,36.67,157,119,276,43.12,78,-41,260,103,-63
6,Saint Paul W-6 P-9,2411,54,255,618,8.74,7.28%,25.63,18.35,41.26,327.5,52.99,120,36.64,264,317,581,54.56,205,-112,409,145,-37
6,Saint Paul W-6 P-10,1019,19,102,277,6.86,11.77%,27.18,15.41,36.82,179.5,64.80,64,35.65,130,148,278,53.24,93,-55,182,52,1
6,Saint Paul W-6 P-11,1716,32,220,571,5.60,11.80%,33.28,21.48,38.53,334.75,58.63,124,37.04,278,307,585,52.48,185,-122,384,106,14
6,Saint Paul W-6 P-12,1197,25,111,325,7.69,9.17%,27.15,17.98,34.15,172.5,53.08,70,40.58,125,206,331,62.24,117,-89,206,81,6
7,Saint Paul W-7 P-1,2157,33,291,459,7.19,9.32%,21.28,11.96,63.40,274.25,59.75,147,53.60,221,241,462,52.16,291,50,291,70,3
7,Saint Paul W-7 P-2,1318,12,108,264,4.55,5.69%,20.03,14.34,40.91,157.5,59.66,75,47.62,104,169,273,61.90,108,-61,108,4,9
7,Saint Paul W-7 P-3,1553,22,178,313,7.03,6.76%,20.15,13.39,56.87,191.25,61.10,100,52.29,159,168,327,51.38,178,10,178,19,14
7,Saint Paul W-7 P-4,935,11,93,188,5.85,8.39%,20.11,11.72,49.47,126.75,67.42,48,37.87,80,115,195,58.97,93,-22,93,13,7
7,Saint Paul W-7 P-5,1382,39,375,472,8.26,18.77%,34.15,15.38,79.45,273.5,57.94,140,51.19,247,223,470,47.45,375,152,375,128,-2
7,Saint Paul W-7 P-6,1452,15,156,274,5.47,6.05%,18.87,12.82,56.93,177,64.60,69,38.98,102,189,291,64.95,156,-33,156,54,17
7,Saint Paul W-7 P-7,1300,22,124,229,9.61,7.82%,17.62,9.80,54.15,155.75,68.01,57,36.60,108,139,247,56.28,124,-15,124,16,18
7,Saint Paul W-7 P-8,1769,26,202,349,7.45,8.19%,19.73,11.54,57.88,217.75,62.39,107,49.14,163,208,371,56.06,202,-6,202,39,22
7,Saint Paul W-7 P-9,1565,18,181,346,5.20,6.83%,22.11,15.28,52.31,214.25,61.92,77,35.94,166,199,365,54.52,181,-18,181,15,19
7,Saint Paul W-7 P-10,1449,19,163,323,5.88,7.70%,22.29,14.59,50.46,202.75,62.77,78,38.47,146,203,349,58.17,163,-40,163,17,26
7,Saint Paul W-7 P-11,1299,5,88,162,3.09,5.23%,12.47,7.24,54.32,115.75,71.45,53,45.79,66,103,169,60.95,88,-15,88,22,7
7,Saint Paul W-7 P-12,2643,53,394,595,8.91,10.37%,22.51,12.14,66.22,373.5,62.77,160,42.84,305,296,601,49.25,394,98,394,89,6
7,Saint Paul W-7 P-13,1928,42,478,615,6.83,13.10%,31.90,18.80,77.72,358.75,58.33,127,35.40,361,286,647,44.20,478,192,478,117,32